absence - absense, absance
acceptable - acceptible 
accommodate - accomodate, acommodate
achieve - acheive
acknowledge - acknowlege, aknowledge
acquaintance - acquaintence, aquaintance
acquire - aquire, adquire 
acquit - aquit 
acreage - acrage, acerage
address - adress
adultery - adultary
advisable - adviseable, advizable
affect - effect
aggression - agression, aggresion
alcohol - alchohol
algorithm - algorythm
allege - alege, allage
allegiance - allegaince, allegience, alegiance
almost - allmost
amateur - amatuer, amature 
amend - ammend
annually - anually, annualy
apparent - apparant, aparent 
arctic - artic
argument - arguement
atheist - athiest
average - avrage, averege
awful - awfull, aweful
balance - ballance, balence
basically - basicly
because - becuase
becoming - becomeing
beginning - begining
believe - beleive 
bellwether - bellweather
buoy/buoyant - bouy/bouyant
burglar - burgler
business - bisness, bizness, buisness
calendar - calender
camouflage - camoflage, camoflague
capitol - capital
career - carrer
careful - carefull
Caribbean - Carribean
category - catagory
caught - cauhgt, caugt
cemetery - cemetary
changeable - changable
chief - cheif
colleague - collaegue, collegue
collectible - collectable
column - colum 
comfortable - confortable
coming - comming
committed - commited, comitted
competition - compitition
concede - conceed
conceive - concieve
congratulate - congradulate
conscientious - consciencious 
conscious - concious, consious 
consensus - concensus
controversy - contraversy
convenience - conveniance
coolly - cooly
criticize - critecize, critisize
daiquiri - dacquiri, daquiri 
deceive - decieve
definite - definate,
definitely - definitly,
desperate - desparate
difference - diffrence
dilemma - dilema
disappoint - disapoint
disastrous - disasterous
drunkenness - drunkeness 
dumbbell - dumbell 
embarrass - embarass
equipment - equiptment 
exceed - excede 
exhilarate - exilerate 
existence - existance 
experience - experiance 
extreme - extreem
fascinating - facinating
fiery - firey 
fluorescent - flourescent
foreign - foriegn 
friend - freind
fulfil - fullfil 
gauge - guage
grateful - gratefull, greatful
guarantee - garantee, garentee, garanty
guidance - guidence 
harass - harrass
height - heighth, heigth 
hierarchy - heirarchy 
humorous - humerous 
hygiene - hygene, hygine, hiygeine, higeine, hygeine
hypocrisy/hypocrite - hipocrit
ignorance - ignorence 
imaginary - imaginery
imitate - immitate
imitation - immitation, imitashun
immediately - imediately
incidentally - incidently
independent - independant 
indispensable - indispensible 
inoculate - innoculate 
intelligence - inteligence, intelligance 
interesting - intresting
interruption - interuption
irrelevant - irrelevent
irritable - irritible
island - iland
jealous - jellous
judgment - judgement 
kernel - kernal
kindergarten - kindergarden
knowledge - knowlege
leisure - liesure 
liaison - liason
library - libary, liberry 
license - lisence
lightning - lightening 
loneliness - lonelyness
lose - loose
losing - loosing, loseing
lying - lieing
maintenance - maintenence, maintnance
marriage - marrige
mathematics - mathmatics
medicine - medcine
medieval - medeval, medevil, mideval 
memento - momento 
millennium - millenium, milennium
miniature - miniture
minuscule - miniscule
minute - minite
mischievous - mischievious, mischevous, mischevious 
misspell - mispell, misspel
mysterious - misterius,
naturally - naturaly
necessary - neccessary, necessery
niece - neice
neighbor - nieghbor 
neither - niether
noticeable - noticable 
occasion - occassion
occasionally - occasionaly, occassionally 
occurrence - occurrance, occurence 
occurred - occured
official - oficial
often - offen
omission - ommision, omision
operate - oprate
opportunity - oppurtunity
optimism - optimisim
original - orignal
outrageous - outragous
paid - payed
parallel - parrallel, parellel, paralell, parallell
parliament - parliment
particularly - particurly
pastime - passtime, pasttime 
peculiar - peculier
perceive - percieve
perform - preform
permanent - pernament, permament
perseverance - perseverence 
personally - personaly
personnel - personell, personel
persuade - persaude
pervious - previous
picture - pichure, pitcher
piece - peice
planning - planing
plagiarize - plagerize
playwright - playright, playwrite
pleasant - plesant
political - pollitical
possession - posession, possesion
potatoes - potatos
practical - practicle
precede - preceed 
prejudice - predjudice
presence - presance
primitive - primative
principle - principal 
privilege - privelege, priviledge
probably - probly
professional - proffesional
professor - professer
promise - promiss 
pronunciation - pronounciation 
proof - prufe 
psychology - psycology
publicly - publically
quantity - quanity
quarantine - quarentine
queue - que 
questionnaire - questionaire, questionnair
quite - quiet
readable - readible 
realize - relize, reelize
really - realy
receive - recieve
receipt - reciept 
recognize - reconize, reckonize
recommend - recomend, reccommend
referred - refered 
reference - referance, refrence 
relevant - relevent, revelant
religious - religous, religius
repetition - repitition
restaurant - restarant, restaraunt 
rhyme - rime, ryme 
rhythm - rythm, rythem
ridiculous - rediculous, ridicolous
sacrifice - sacrefice
safety - saftey, safty
Saturday - Saterday
scissors - sissors
secretary - secratary, secretery
seize - sieze
separate - seperate
sergeant - sargent 
shining - shineing
similar - similer,
sincerely - sinceerly
skilful - skilfull 
soldier - solider
speech - speach, speeche 
stopping - stoping
strength - strenght
succeed - succede
successful - succesful, successfull, sucessful
supersede - supercede 
surely - surelly
surprise - suprise, surprize
tattoo - tatoo
their - there
too - to
tomatoes - tomatos
tomorrow - tommorrow
twelfth - twelth 
tyranny - tyrany 
underrate - underate
until - untill 
upholstery - upholstry
using - useing
usually - usualy
vacuum - vaccuum, vacume 
vegetarian - vegatarian
vehicle - vehical
vicious - visious
weather - wether 
weird - wierd
welfare - wellfare, welfair
whether - wether
withhold - withold
writing - writting, writeing 
